s 1 s 1 s 1 s 1 a 4 a 4 a 4 a 4 s 1 s 1 s 1 s 1
s 1 s 1 s 1 a 3 a 3 a 3 a 3 a 3 a 3 s 1 s 1 s 1
s 1 s 1 a 2 a 2 a 2 a 2 a 2 a 2 a 2 a 2 s 1 s 1 
s 1 a 1 a 1 a 1 a 1 a 1 a 1 a 1 a 1 a 1 a 1 s 1
x 1 a 0 a 0 a 0 a 0 a 0 a 0 a 0 a 0 a 0 a 0 g 1
e 1 e 1 e 1 e 1 e 1 e 1 e 1 e 1 e 1 e 1 e 1 e 1
l 1 h 1 l 1 h 1 l 1 h 1 l 1 h 1 l 1 h 1 l 1 h 1
e 1 e 1 e 1 e 1 e 1 e 1 e 1 e 1 e 1 e 1 e 1 e 1
h 1 h 1 h 1 m 1 m 1 m 1 m 1 m 1 m 1 h 1 h 1 h 1
p 1 h 1 h 1 h 1 h 1 h 1 h 1 h 1 h 1 h 1 h 1 p 1
s 1 s 1 s 1 e 1 e 1 e 1 e 1 e 1 e 1 s 1 s 1 s 1
s 1 s 1 e 1 e 1 e 1 e 1 e 1 e 1 e 1 e 1 s 1 s 1
s 1 e 1 e 1 e 1 e 1 e 1 e 1 e 1 e 1 e 1 e 1 s 1
e 1 e 1 e 1 e 1 e 1 e 1 e 1 e 1 e 1 e 1 e 1 e 1
e 1 e 1 e 1 e 1 e 1 e 1 e 1 e 1 e 1 e 1 e 1 e 1
e 1 e 1 e 1 e 1 e 1 e 1 e 1 e 1 e 1 e 1 e 1 e 1
e 1 e 1 e 1 e 1 e 1 e 1 e 1 e 1 e 1 e 1 e 1 e 1
e 1 e 1 e 1 e 1 e 1 e 1 e 1 e 1 e 1 e 1 e 1 e 1
e 1 e 1 e 1 e 1 e 1 e 1 e 1 e 1 e 1 e 1 e 1 e 1
e 1 e 1 e 1 e 1 e 1 e 1 e 1 e 1 e 1 e 1 e 1 e 1
e 1 e 1 e 1 e 1 e 1 e 1 e 1 e 1 e 1 e 1 e 1 e 1
e 1 e 1 e 1 e 1 e 1 e 1 e 1 e 1 e 1 e 1 e 1 e 1
e 1 e 1 e 1 e 1 e 1 e 1 e 1 e 1 e 1 e 1 e 1 e 1
e 1 e 1 e 1 e 1 e 1 e 1 e 1 e 1 e 1 e 1 e 1 e 1
e 1 e 1 e 1 e 1 e 1 e 1 e 1 e 1 e 1 e 1 e 1 e 1
e 1 e 1 e 1 e 1 e 1 e 1 e 1 e 1 e 1 e 1 e 1 e 1
e 1 e 1 e 1 e 1 e 1 e 1 e 1 e 1 e 1 e 1 e 1 e 1
e 1 e 1 e 1 e 1 e 1 e 1 e 1 e 1 e 1 e 1 e 1 e 1
e 1 e 1 e 1 e 1 e 1 e 1 e 1 e 1 e 1 e 1 e 1 e 1
e 1 e 1 e 1 e 1 e 1 e 1 e 1 e 1 e 1 e 1 e 1 e 1
e 1 e 1 e 1 e 1 e 1 e 1 e 1 e 1 e 1 e 1 e 1 e 1
e 1 e 1 e 1 e 1 e 1 e 1 e 1 e 1 e 1 e 1 e 1 e 1
e 1 e 1 e 1 e 1 e 1 e 1 e 1 e 1 e 1 e 1 e 1 e 1
e 1 e 1 e 1 e 1 e 1 e 1 e 1 e 1 e 1 e 1 e 1 e 1
e 1 e 1 e 1 e 1 e 1 e 1 e 1 e 1 e 1 e 1 e 1 e 1
i 1 i 1 i 1 i 1 i 1 i 1 i 1 i 1 i 1 i 1 i 1 i 1
