a 3 a 2 a 1 a 0 e 1 e 1 e 1 e 1 a 0 a 1 a 2 a 3
a 2 a 3 a 2 a 1 a 0 e 1 e 1 a 0 a 1 a 2 a 3 a 2
a 1 a 2 a 3 a 2 a 1 a 0 a 0 a 1 a 2 a 3 a 2 a 1
a 0 a 1 a 2 a 3 a 2 a 1 a 1 a 2 a 3 a 2 a 1 a 0
e 1 a 0 a 1 a 2 a 3 a 2 a 2 a 3 a 2 a 1 a 0 e 1
e 1 e 1 a 0 a 1 a 2 h 3 x 3 a 2 a 1 a 0 e 1 e 1
e 1 e 1 a 0 a 1 a 2 h 3 h 3 a 2 a 1 a 0 e 1 e 1
e 1 a 0 a 1 a 2 a 3 a 2 a 2 a 3 a 2 a 1 a 0 e 1
a 0 a 1 a 2 a 3 a 2 a 1 a 1 a 2 a 3 a 2 a 1 a 0
a 1 a 2 a 3 a 2 a 1 a 0 a 0 a 1 a 2 a 3 a 2 a 1
a 2 a 3 a 2 a 1 a 0 e 1 e 1 a 0 a 1 a 2 a 3 a 2
a 3 a 2 a 1 a 0 e 1 e 1 e 1 e 1 a 0 a 1 a 2 a 3
a 2 a 1 a 0 e 1 e 1 e 1 e 1 e 1 e 1 a 0 a 1 a 2
a 1 a 0 e 1 e 1 e 1 e 1 e 1 e 1 e 1 e 1 a 0 a 1
a 0 e 1 e 1 e 1 e 1 e 1 e 1 e 1 e 1 e 1 e 1 a 0
e 1 e 1 e 1 e 1 e 1 e 1 e 1 e 1 e 1 e 1 e 1 e 1
e 1 e 1 e 1 e 1 e 1 e 1 e 1 e 1 e 1 e 1 e 1 e 1
e 1 e 1 e 1 e 1 e 1 e 1 e 1 e 1 e 1 e 1 e 1 e 1
e 1 e 1 e 1 e 1 e 1 e 1 e 1 e 1 e 1 e 1 e 1 e 1
e 1 e 1 e 1 e 1 e 1 e 1 e 1 e 1 e 1 e 1 e 1 e 1
e 1 e 1 e 1 e 1 e 1 e 1 e 1 e 1 e 1 e 1 e 1 e 1
e 1 e 1 e 1 e 1 e 1 e 1 e 1 e 1 e 1 e 1 e 1 e 1
e 1 e 1 e 1 e 1 e 1 e 1 e 1 e 1 e 1 e 1 e 1 e 1
e 1 e 1 e 1 e 1 e 1 e 1 e 1 e 1 e 1 e 1 e 1 e 1
e 1 e 1 e 1 e 1 e 1 e 1 e 1 e 1 e 1 e 1 e 1 e 1
e 1 e 1 e 1 e 1 e 1 e 1 e 1 e 1 e 1 e 1 e 1 e 1
e 1 e 1 e 1 e 1 e 1 e 1 e 1 e 1 e 1 e 1 e 1 e 1
e 1 e 1 e 1 e 1 e 1 e 1 e 1 e 1 e 1 e 1 e 1 e 1
e 1 e 1 e 1 e 1 e 1 e 1 e 1 e 1 e 1 e 1 e 1 e 1
e 1 e 1 e 1 e 1 e 1 e 1 e 1 e 1 e 1 e 1 e 1 e 1
e 1 e 1 e 1 e 1 e 1 e 1 e 1 e 1 e 1 e 1 e 1 e 1
e 1 e 1 e 1 e 1 e 1 e 1 e 1 e 1 e 1 e 1 e 1 e 1
e 1 e 1 e 1 e 1 e 1 e 1 e 1 e 1 e 1 e 1 e 1 e 1
i 1 i 1 i 1 i 1 i 1 i 1 i 1 i 1 i 1 i 1 i 1 i 1
i 1 i 1 i 1 i 1 i 1 i 1 i 1 i 1 i 1 i 1 i 1 i 1
i 1 i 1 i 1 i 1 i 1 i 1 i 1 i 1 i 1 i 1 i 1 i 1
